|0, 1, 1, 1, 1, 1, r, 
|1, 1, 1, 1, 1, 1, 1, 
|1, 1, X, 1, 1, 1, 1, 
|1, 1, 0, 1, 1, 1, 1, 
|1, 1, 0, 1, 1, 1, 1, 
|X, X, 0, X, X, X, X, 
